{
   "tiles" : [ [1, 1, 1, 1, 1, 1, 1, 1, 1 ],
			   [0, 0, 1, 1, 1, 1, 1, 1, 1 ],
			   [1, 0, 0, 1, 1, 1, 1, 1, 1 ],
			   [1, 1, 0, 0, 1, 1, 1, 1, 1 ],
			   [1, 1, 1, 0, 0, 1, 1, 1, 1 ],
			   [1, 1, 1, 1, 0, 0, 1, 1, 1 ],
			   [1, 1, 1, 1, 1, 0, 0, 1, 1 ],
			   [1, 1, 1, 1, 1, 1, 0, 0, 1 ],
			   [1, 1, 1, 1, 1, 1, 1, 0, 1 ] ],
	
  "targetScore" : 1500,
  "moves" : 15,
	
  "pastries" : [4,5,6,7,8,9,10,11]
}
