{
   "tiles" : [ [1, 1, 1, 1, 1, 1, 1, 1, 1 ],
			   [1, 1, 1, 1, 1, 1, 1, 1, 1 ],
			   [0, 0, 0, 0, 1, 0, 0, 0, 0 ],
			   [1, 1, 1, 0, 1, 0, 1, 1, 1 ],
			   [1, 1, 1, 0, 1, 0, 1, 1, 1 ],
			   [1, 1, 1, 0, 1, 0, 1, 1, 1 ],
			   [0, 0, 0, 0, 1, 0, 0, 0, 0 ],
			   [1, 1, 1, 1, 1, 1, 1, 1, 1 ],
			   [1, 1, 1, 1, 1, 1, 1, 1, 1 ] ],

  "targetScore" : 1200,
  "moves" : 15,
	
  "pastries" : [1,3,6,9,10,11,12]
}
