{
	"tiles" : [ [1, 1, 1, 1, 1, 1, 1, 1, 1 ],
			   [1, 1, 0, 1, 1, 0, 1, 1, 1 ],
			   [1, 1, 1, 1, 1, 1, 1, 0, 1 ],
			   [1, 1, 0, 1, 1, 1, 1, 1, 1 ],
			   [1, 1, 1, 1, 1, 1, 0, 1, 1 ],
			   [1, 1, 1, 0, 1, 1, 1, 1, 1 ],
			   [1, 0, 1, 1, 1, 0, 1, 1, 1 ],
			   [1, 1, 1, 0, 1, 1, 1, 0, 1 ],
			   [1, 1, 1, 1, 1, 1, 1, 1, 1 ] ],

  "targetScore" : 2000,
  "moves" : 15,
	
  "pastries" : [1,2,3,4,5,6,7,8,9]
}
