{
	"tiles" : [[1, 1, 1, 0, 1, 1, 0, 1, 1 ],
			   [0, 1, 1, 1, 1, 1, 1, 1, 0 ],
			   [1, 1, 1, 0, 1, 0, 1, 1, 1 ],
			   [0, 1, 1, 0, 1, 0, 1, 1, 0 ],
			   [1, 1, 1, 0, 1, 0, 1, 1, 1 ],
			   [0, 1, 1, 0, 1, 0, 1, 1, 0 ],
			   [1, 1, 1, 0, 1, 0, 1, 1, 1 ],
			   [0, 1, 1, 1, 1, 1, 1, 1, 0 ],
			   [1, 1, 0, 1, 1, 0, 1, 1, 1 ] ],

  "targetScore" : 1500,
  "moves" : 15,
	
  "pastries" : [1,3,5,7,9,11]
}
