{
   "tiles" : [ [1, 1, 1, 1, 1, 1, 1, 1, 1 ],
			   [1, 0, 0, 0, 0, 0, 0, 0, 1 ],
			   [1, 0, 1, 1, 1, 1, 1, 0, 1 ],
			   [1, 0, 1, 0, 0, 0, 1, 0, 1 ],
			   [1, 0, 1, 0, 1, 0, 1, 0, 1 ],
			   [1, 0, 1, 0, 0, 0, 1, 0, 1 ],
			   [1, 0, 1, 1, 1, 1, 1, 0, 1 ],
			   [1, 0, 0, 0, 0, 0, 0, 0, 1 ],
			   [1, 1, 1, 1, 1, 1, 1, 1, 1 ] ],

  "targetScore" : 1100,
  "moves" : 20,
	
  "pastries" : [1,2,3,4,5,6,7]
}
